# Check it out: http://humanstxt.org/

# TEAM

    Mailan Reiser -- Queen Zeal
    Don Page -- Hero
    Rob Messick -- Breaker of Things
    Will Wheeler -- Bug Hunter
    Bolot Kerimbaev -- Mitsurugi
    David Shi -- Vimer
    Rob Phillips -- BreakingBadly
    Jeremy Pollard -- Connector of Tubes
    Jacob Poye -- TexMachina
    Jia Feng -- Sleeping Lizard
    Zhejun Wu -- Petitsfours
    David Nguyen -- Fast Turtle
    Campbell Belden -- Squishybrain
    Felix Cheng -- Aspiring Elf
    Matt Harmer -- zer0c001
    Feng Guo -- Code Monkey
    Patrick Aldea -- Last Defense
    Yuliya Kovalenko -- üêº
    Michael Langley -- Asgardian Developer
    Ashley Parker -- Jedi Master
    Nick Martin -- Certified Bounty Hunter
    Gaurav Tamhan -- Running Man
    Valentina Alfonso -- Argentinean Mate
    Patrick Narciso -- The Brazilian Developer
    Gabriel Martinez -- Mecha Pilot
    Gabriel Castillo -- Nightwolf
    Graig Patrick -- Dragon Hunter
    Fred Ajani -- Ace Corouna
    Juan Torrijos -- The Panamanian
    Samuel Eguino -- Average Anime Enjoyer
